grades - оценки
greetings - приветствие
loop nested - список вложенный
combined - комбинированный
quantity - количество
price - цена
update - обновить
get - 
full - полный
change price - изменить цену
class constructor - конструктор класса
currency - валюта
month - месяц
power - сила, мощность
rate - ставка
example - пример
Did you mean - Вы имели в виду.
employee - работник
self - сам 
owner - владелец 
balance - баланс 
current - текущий
current task - текущая задача
I miss - я скучаю
amount - сумма
places - места
seating - сидение
standing - стоящий
follow - следовать
deep - глубокий
built - выполненный, построенный
is even - является четным
digits - цифры
fix it - исправь это
takes - принимает
but - но 
given - даны, подаренный
were - были
available - доступный
